{
  "level1": {
    "name": "Tidal Drift",
    "tileSize": 32,
    "width": 20,
    "height": 12,

    "layers": {
      "layout": [
        "##..................",
        "#..................E",
        "...####.............",
        "...#................",
        "...#......#####.....",
        "...#........#.......",
        "...#.......#####....",
        "...#................",
        "...................#",
        "......S...........##",
        "..............######",
        "...........#########"
      ],

      "currents": [
        "....................",
        ".............wwwwww.",
        "....................",
        "....................",
        "....................",
        "....................",
        "....................",
        "....................",
        "...qqqqq............",
        "...qqqqq............",
        "...qqqqq............",
        "...................."
      ],

      "hazards": [
        "....................",
        "....................",
        "....................",
        "....................",
        "....................",
        "....................",
        "...........####.....",
        "...........#..#.....",
        "...........####.....",
        "....................",
        "....................",
        "...................."
      ],

      "entities": [
        "....................",
        "....................",
        "....................",
        "....................",
        ".............1......",
        "....................",
        "....................",
        "....................",
        "....................",
        "....................",
        "....................",
        "...................."
      ]
    },

    "currentsLegend": {
      "q": { "dx":5, "dy": 0, "style": "current", "params": {} },
      "w": { "dx": 0, "dy": 0, "style": "current", "params": {} }
    },

    "entityLegend": {
      "1": { "type": "enemy", "speed": 80, "path": [{ "x": 10, "y": 6 }, { "x": 15, "y": 6 }] }
    }
  }
}