{
  "level1": {
    "name": "Hello World",

    "layers": {
      "layout": [
        "##...................",
        "#....................",
        "...#############.....",
        "...#############.....",
        "...#############.....",
        "...###....######.....",
        "...#...S...#####.....",   
        ".....................",
        "...................##",
        "..................###",
        "..............#######",
        "E..........##########"
      ],

      "currents": [
        "eeeewwww.........wwww",
        "eeeewwwwwwwwwwwwwwwww",
        "eee......wwwwww..wWww",
        "ee...................",
        "ee...................",
        "ee...................",
        "ee...................",
        "ee...................",
        "ee..qqqqqqqqqqqqqq...",
        "...qqqqqqqqq.........",
        "...qqqqq.............",
        "....................."
      ],

      "hazards": [
        ".....................",
        ".....................",
        ".....................",
        ".....................",
        ".....................",
        ".....................",
        ".....................",
        ".....................",
        ".....................",
        ".....................",
        ".....................",
        "....................."
      ],

      "entities": [
        ".....................",
        ".....................",
        ".....................",
        ".....................",
        ".....................",
        ".....................",
        ".....................",
        ".....................",
        ".....................",
        ".....................",
        ".....................",
        ".........g..........."
      ]
    },

    "currentsLegend": {
      "q": { "dx":6, "dy": 0, "style": "current", "params": {} },
      "w": { "dx": -5, "dy": 1, "style": "current", "params": {} },
      "e": { "dx": -2, "dy": 5, "style": "current", "params": {} }
    },

    "entityLegend": {
      "g": { "type": "grass", "direction": "up" }
    },
    "hazardLegend": {
    }
  },

  "level2": {
    "name": "Floppy Bird",

    "layers": {
      "layout": [
        "S.#.......#.......#..",
        "..#...#...#..........",
        "......#...#...#......",
        "..#...#.......#...#..",
        "..#...#.......#...#..",
        "..........#.......#..",
        "..........#.......#..",
        "..#...#...#...#...#..",
        "..#...#.......#...#..",
        "......#...#...#...#..",
        "..#...#...#...#...#..",
        "..#...........#...#.E"
      ],

      "currents": [
        "...............ff....",
        "..............bbffff.",
        "bbbbbbb......bbbffff.",
        "...uuu..ffff..bb.....",
        "...uuubffffff........",
        "...uubb..............",
        "fff.ubb......rrr.....",
        "ffff.........rrr.....",
        "...d......fffdd......",
        ".fffd.....fffdd......",
        "...ddd.......dd......",
        "...ffff..bbbbbb......"
      ],

      "hazards": [
        ".....................",
        ".....................",
        ".....................",
        ".....................",
        ".....................",
        ".....................",
        ".....................",
        ".....................",
        ".....................",
        ".....................",
        ".....................",
        "....................."
      ],

      "entities": [
        ".....................",
        ".....................",
        ".....................",
        ".....................",
        ".....................",
        ".....................",
        ".....................",
        ".....................",
        ".....................",
        ".....................",
        ".....................",
        "....................."
      ]
    },

    "currentsLegend": {
      "b": { "dx":-5, "dy": 0, "style": "current", "params": {} },
      "f": { "dx":5, "dy": 0, "style": "current", "params": {} },
      "d": { "dx": 0, "dy": 5, "style": "current", "params": {} },
      "u": { "dx": 0, "dy": -5, "style": "current", "params": {} },
      "r": { "dx": 3, "dy": 5, "style": "current", "params": {} }
    },

    "entityLegend": {
    },
    "hazardLegend": {
    }
  },
  "level3": {
    "name": "Test",
    "layers": {
      "layout": [
        ".....................",
        ".....................",
        ".....................",
        "...###############...",
        ".....................",
        "................E....",
        ".....................",
        ".....................",
        ".....................",
        "....S................",
        ".....................",
        "....................."
      ],
      "currents": [
        ".....................",
        ".....................",
        ".....................",
        ".....................",
        ".....................",
        ".....................",
        ".....................",
        ".....................",
        ".....................",
        ".....................",
        ".....................",
        "....................."
      ],
      "hazards": [
        ".....................",
        ".....................",
        ".....................",
        ".....................",
        ".....................",
        ".....................",
        ".....................",
        ".....................",
        ".....................",
        ".....................",
        ".....................",
        "....................."
      ],
      "entities": [
        ".....................",
        ".....................",
        ".....................",
        ".....................",
        ".....................",
        ".....................",
        ".....................",
        ".....................",
        ".....................",
        ".....................",
        ".....................",
        "....................."
      ]
    },
    "currentsLegend": {
    },
    "entityLegend": {
    },
    "hazardLegend": {
    }
  }
}