{
  "level1": {
    "name": "Tidal Drift",
    "tileSize": 32,
    "width": 20,
    "height": 12,

    "layers": {
      "layout": [
        "####################",
        "#..................E",
        "#..####............#",
        "#..#...............#",
        "#..#......#####....#",
        "#..#........#......#",
        "#S.#.......#####...#",
        "#..#...............#",
        "#..................#",
        "#.................##",
        "..............######",
        "####################"
      ],

      "currents": [
        "....................",
        "....wwwwww..........",
        "....w....w..........",
        "....w....w..........",
        "....w....w..........",
        "....w....w..........",
        "....w....w..........",
        "....w....w..........",
        "....wwwwww..........",
        "....................",
        "....................",
        "...................."
      ],

      "hazards": [
        "....................",
        "....................",
        "....................",
        "....................",
        "....................",
        "....................",
        "...........####.....",
        "...........#..#.....",
        "...........####.....",
        "....................",
        "....................",
        "...................."
      ],

      "entities": [
        "....................",
        "....................",
        "....................",
        "....................",
        ".............1......",
        "....................",
        "....................",
        "....................",
        "....................",
        "....................",
        "....................",
        "...................."
      ]
    },

    "currentsLegend": {
      "w": { "dx": 0, "dy": -0.5 },
      "a": { "dx": -0.5, "dy": 0 },
      "s": { "dx": 0, "dy": 0.5 },
      "d": { "dx": 0.5, "dy": 0 },
      "e": { "dx": 0.35, "dy": -0.35 },
      "z": { "dx": -0.35, "dy": 0.35 },
      "q": { "dx": -0.35, "dy": -0.35 },
      "c": { "dx": 0.35, "dy": 0.35 }
    },

    "entityLegend": {
      "1": { "type": "enemy", "speed": 80, "path": [{ "x": 10, "y": 6 }, { "x": 15, "y": 6 }] }
    }
  }
}