

{
  "level1": {
    "name": "Starter Maze",
    "width": 20,
    "height": 10,
    "tileSize": 32,
    "spawn": { "x": 64, "y": 164 },
    "goal": { "x": 550, "y": 250 },
    "layout": [
      "####################",
      "#..............#...#",
      "#..............#...#",
      "#..####........#...#",
      "#..............#...#",
      "#..............#...#",
      "#..............#...#",
      "#....#####.........#",
      "#..............#...#",
      "####################"
    ]
  }
}